************************************
*........................ *........*
*..P.M..............#.....*........*
******************.........****....*
*................*.................*
**************...**********........*
**************...............*.....*
*...........................*.....*
***********....**************......*
*....................*.............*   
************************************